1111111111111111111111111111
1000000000000000000000000001
1031110111110110111110111101
1111110111110110111110111121
1011110111110110111110111101
1000000000000000000000000001
1011110110110110111110111101
1011110110110110111110111101
1000000000000000000000000001
1101110111111101101110111011
1101110110000000000010111011
1101110110111100111110111011
1101110110133333333310111011
1000000000133333333310000001
1111110110133333333310111111
1111110110133333333310111111
1111110110111111111110111111
1000000000000000002000000001
1011110111110110111110111111
1000110000020000000000110001
1110110110111111110110110111
1110110110111111110110110111
1002000110000110000110000001
1011111111110110111111111101
1011111111110110111111111101
1000000000000020000000000001
1111111111111111111111111111
